1111111111111111111111111111111111
1S10000000000000000000000000000001
1000010100100000101001000000010101
111001001110101000100100O000010101
1000000000101000000000000000000101
1111111111111111111111111111111111