1111111111111111111111111111111111
1000000000000000000000000000000001
100001010010000N001001000000010101
111001001110100000100100O000010101
1000000000101000000000000000000101
1111111111111111111111111111111111