1111111111111111111111111111111111
1000000000000000000000000000000001
100000000000000S000000000000000001
1000000000000000000000000000000001
1000000000000010100000000000000001
1111111111111111111111111111111111