11111111111111111111111111111111111
10000000000000000000000000000000001
1000000B0000000000000000000B0000001
10000000000000000S00000000000000001
1000000B0000000000000000000B0000001
10000000000000000000000000000000001
11110111100000000000000000111101111
10000000100000000000000000100000001
1000C000100000000000000000100000001
11111111111111111111111111111111111