NO ./textures/wall/wallN.xpm
EA ./textures/wall/wallE.xpm
SO ./textures/wall/wallS.xpm
WE ./textures/wall/wallW.xpm

F 220,100,0
C 255,30,0

		0000000000000000000000000
        1111111111111111111111111
        1000000000110000000000001
        1010000001110000000000001
        1001000000000000000B00001
111111111011000001110000000000001
100000000011000001110111111111111
11110111111111011100000010001
11110111111111011101010010001
1100000011010101110000 0D0001
100B0000000000001100000010C01
100000000B0000001101010010001
110B0001110101011111011110N0111
11110111 1110101 101111010001
11111111 1111111 111111111111