NO ./textures/wall/wallN.xpm
F          220,100,0
EA ./textures/wall/wallE.xpm
SO ./textures/wall/wallS.xpm
WE ./textures/wall/wallW.xpm

C 255,30,0
        0000000000000                         000000000000
        1111111111111111111111111
        1000000000110000000000001
        1010000001110000000000001
        1001000000000000000000001
111111111011000001110000000000001
100000000011000001110111111111111
11110111111111011100000010001
11110111111111011101010010001

11111111111111111111101111111
1100000011010101110000 000001
10000S000000000011000000D0001
10000000000000001101010010001
11000001110101011111011110C0111
11110111 1110101 101111010001
11111111 1111111 111111111111